
step = steppu ()

angle = 角度, アングル (Kakudo)

sasetdu = turn left

hidari ni magaru

left = 左, レフト (Hidari)

right = 右, レフト (Migi)

forward = 進む, mai susumu

backward = ushiro ni modoru

File = ファイル (fairu)

Turtle = 亀 カメ (kame) 

Triangle = 三角形, (Sankakkei)

Square = 四角形, (shikakukei)

Circle = 円, サークル, (enn)

Parenthesis = 括弧, (kakko)

Square brackets [] = 大かっこ, (dai Kakko)

Addition = 足し算, (tashizan)

Multiplication = 掛け算, (kakezan)

Substraction = 引き算, (Hikizan)

Division = 割り算, (Warizan)

Modulo = 余り, (amari)

Repetition = 繰り返し, (Kurikaeshi)

------- Programming concepts -------

variables hensu

function kansu

parameters 

invokation of function yobidashi

Compile 

compile error 

runtime 

Runtime error

(samples/flower)
